20 20
####################
#    #             #
#    #             #
#    ##            #
#     #     #      #
#           #      #
#           ####   #
#              #   #
#              #   #
#                  #
#                  #
#                  #
#                  #
#                  #
#           #      #
#           ####   #
#              #   #
#              #   #
#                  #
####################