20 20
####################
#    #             #
# @  #             #
#    ##            #
#     #     #^     #
#           #      #
#           ####   #
#              #   #
#              #   #
#                  #
#   &              #
#   &              #
#             ^   @#
#                  #
#           # ^    #
#           ####   #
#              #   #
#    ^         #   #
#                  #
####################