10 10
##########
#    #   #
#    #   #
#    ##  #
#     #  #
#        #
#        #
#        #
#        #
##########